List of psychotropic medications
List of medications which are used to treat psychiatric conditions that are on the market in the United States (this list is incomplete; the title of the entry is "List of Psychotropic Medications" and what follows is a list of psychiatric drugs - not all psychotropic agents are used to treat psychiatric conditions.

A [ edit ]

B [ edit ]

benperidol (Benperidol) - an antipsychotic primarily used to control antisocial hypersexual behaviour

brexpiprazole (Rexulti) - a dopamine D2 receptor partial agonist used to treat major depressive disorder

BuSpar (buspirone) – an anti-anxiety medication

Belsomra

C [ edit ]

D [ edit ]

E [ edit ]

F [ edit ]

Fetzima (levomilnacipran) - a serotonin–norepinephrine reuptake inhibitor antidepressant

G [ edit ]

Geodon (ziprasidone) - atypical antipsychotic used to treat schizophrenia and bipolar mania

Gabitril (tiagabine) - used off-label in the treatment of anxiety disorders and panic disorder

H [ edit ]

Haldol (haloperidol) - a "typical" antipsychotic, one of the oldest, usually given in conjunction with "Cogentin" (benzotropine), an antiparkinsonic. This is due to the high occurrence of tardive dyskinesia in patients with prolonged Haldol use. May be used as a last resort treatment for agitated delirium associated with delirium tremens.

I [ edit ]

K [ edit ]

L [ edit ]

Lamotrigine (brand named Lamictal) - a mood stabilizer of the anticonvulsant class

Latuda (lurasidone) - an atypical anti-psychotic

Lexapro (escitalopram) - an antidepressant of the selective serotonin reuptake inhibitor class

Librium (chlordiazepoxide) - the first approved medication of the benzodiazepine class. Mostly used to treat acute alcohol withdrawal.

Lithium (Lithobid, Eskalith) - known more commonly by its generic name, a mood stabilizer used in treating bipolar disorder

Lunesta (eszopiclone) - a non-benzodiazepine sedative hypnotic sleep aid

Luvox (fluvoxamine) - an antidepressant of the selective serotonin reuptake inhibitor class, often used to treat Obsessive-compulsive disorder

Loxitane (loxapine) - an antipsychotic, only rarely used nowadays

M [ edit ]

Mellaril (thioridazine) - an antipsychotic, only rarely used nowadays

Methylphenidate (Ritalin) - a central nervous system stimulant. It is used to treat attention deficit hyperactivity disorder, narcolepsy or augment for depression.

Melatonin - a hypnotic used to treat insomnia

N [ edit ]

Naltrexone (ReVia) - an opioid antagonist primarily used in the management of alcohol dependence, opioid dependence or other impulse control/addictive behaviors such as habitual self-mutilation; also used in formulation with bupropion (bupropion/naltrexone) to treat obesity

Navane (tiotixene) - an antipsychotic, only rarely used nowadays

Neurontin (gabapentin) - an anticonvulsant (anti-seizure medication) which is sometimes used as a mood stabilizer, anti-anxiety agent or to treat chronic pain, particularly diabetic neuropathy

P [ edit ]

Pamelor

Paxil (paroxatine) - a selective serotonin reuptake inhibitor antidepressant, used frequently to treat depression and anxiety disorders

Phenelzine (Nardil) - monoamine oxidase inhibitor, for depression

Pimozide (Orap) - a typical antipsychotic used to treat tic disorders

Pristiq (desvenlafaxine) - a selective serotonin-norepinephrine reuptake inhibitor antidepressant

Prolixin (fluphenazine) - a typical antipsychotic

Prozac (fluoxetine) - a selective serotonin reuptake inhibitor antidepressant

Phenobarbital (Luminal) - a barbiturate, sedative and hypnotic properties

Q [ edit ]

Quetiapine (Seroquel or Seroquel XR) - an atypical antipsychotic mainly used to treat schizophrenia and bipolar disorder; sometimes is used as a sleep aid when given in low doses

R [ edit ]

Remeron (mirtazapine) - an atypical antidepressant which is often used as a sleep aid

Restoril (temazepam) - a sleep aid of the benzodiazepine class

Risperdal (risperidone) - an atypical antipsychotic used to treat schizophrenia, bipolar disorder and irritability associated with autism

Ritalin (methylphenidate) - a stimulant used to treat attention deficit/hyperactivity disorder

Reminyl (galantamine) - used to slow the progression of Alzheimer's dementia

ReVia (naltrexone)

S [ edit ]

Serax (oxazepam) - anti-anxiety medication of the benzodiazepine class, often used to help during detoxification from alcohol or other drugs of abuse

Stelazine (trifluoperazine) - a typical antipsychotic, only rarely used nowadays

Strattera (atomoxetine) - a non-stimulant medication used to treat attention deficit disorder and attention deficit hyperactivity disorder

T [ edit ]

Thorazine - (chlorpromazine) the first antipsychotic although highly effective, it is rarely used nowadays because of the high rate of serious side effects

Topamax - (topiramate) a mood stabilizer, also used for migraine headaches

Trazodone (Deseryl) - an atypical antidepressant of the serotonin antagonist and reuptake inhibitor class, most typically used as a sleep aid

Trileptal - (oxcarbazepine) a mood stabilizer used to treat bipolar disorder

Trintellix (vortioxetine) - serotonin stimulator and modulator antidepressant, used to treat major depressive disorder

Tegretol - (carbamazepine) anti-seizure that can also be used as a mood stabilizer

V [ edit ]

Valium (diazepam) - anti-anxiety medication of the benzodiazepine class

Vistaril (hydroxyzine) - an antihistamine for the treatment of itches and irritations, an antiemetic, as a weak analgesic, an opioid potentiator, and as an anxiolytic.

Vyvanse (lisdexamfetamine) - a stimulant used to treat attention deficit hyperactivity disorder and binge eating disorder; Vyvanse is converted into Dexedrine in vivo .

. Viibryd (vilazodone) - a new antidepressant

Vraylar (Cariprazine) - an atypical antipsychotic used to treat schizophrenia and bipolar disorder

W [ edit ]

X [ edit ]

Xanax (alprazolam) - an anti-anxiety medication of the benzodiazepine class